1111111111111
11000001C10C1
1001110000001
10100011111C1
1P00100000E11
1111111111111