111111111111
11P1C00010C1
1001101C0011
100C001C1E11
111111111111