11111111111111111111
1P000C00000000C00001
100000C00000000000C1
100C000000000C000001
100000000C0000000001
10000C0000000C000001
100C00000000000000E1
11111111111111111111