11111111111111111111111111111111111111111
10000C1000000000100P00100C10000C1000100C1
10111110111111101011101011101111101010111
1000000000001000101C100010001000101010001
11111111101010111010111010111010101011101
1C10001C101010100000001000100010001000001
10101010101010101111101110101111111010101
10101010001010000000100C1000100000001C101
10101011111011111110111111111010101111101
100010100010100000100010000000101C10001C1
11101010101010111010101011111110111010111
100010001000100010001C1000000010000010001
10111111111111101111111111111011111111101
101000000000000010000010000C10001C1000001
10101111111111111011101011111110101010111
101000000010000C1010000010000000100010001
10111111101010111010111110111111111111101
1010001C100010100010100010000000100000101
10101010111110101110101011111110101110101
10001000000C10001C001E1000000000100C10001
11111111111111111111111111111111111111111
